littler - GNU R scripting and command-line front-end -- transition package
r-base - GNU R 統計計算・グラフィックスシステム
r-base-core - 統計およびグラフィックシステム GNU R の中核パッケージ
r-base-core-dbg - GNU R debug symbols for statistical comp. language and environment
r-base-dev - GNU R installation of auxiliary GNU R packages
r-base-html - GNU R html docs for statistical computing system functions
r-cran-abind - GNU R abind 多次元行列結合関数
r-cran-acepack - 回帰変換用 GNU R パッケージ
r-cran-bayesm - ベイズ推定用 GNU R パッケージ
r-cran-boot - Davison と Hinkley による関数のブートストラッピング用 GNU R パッケージ
r-cran-car - John Fox による応用回帰への GNU R ガイド
r-cran-cluster - GNU R package for cluster analysis by Rousseeuw et al
r-cran-coda - R による MCMC シミュレーション用出力分析および診断
r-cran-codetools - GNU R package providing code analysis tools
r-cran-evd - 極値分布のための GNU R 関数
r-cran-fasianoptions - GNU R package for financial engineering -- fAsianOptions
r-cran-fbasics - GNU R package for financial engineering -- fBasics
r-cran-fcopulae - GNU R package for financial engineering -- fCopulae
r-cran-fexoticoptions - GNU R package for financial engineering -- fExoticOptions
r-cran-fextremes - GNU R package for financial engineering -- fExtremes
r-cran-fmultivar - GNU R package for financial engineering -- fMultivar
r-cran-foptions - 金融工学用 GNU R パッケージ -- fOptions
r-cran-foreign - GNU R package to read/write data from other stat. systems
r-cran-fportfolio - GNU R package for financial engineering -- fPortfolio
r-cran-gdata - GNU R package with data manipulation tools by Greg Warnes et al
r-cran-genetics - 集団遺伝学用 GNU R パッケージ
r-cran-gmodels - Greg Warnes などによるモデル適合のためのツール付き GNU R パッケージ
r-cran-gplots - GNU R package with tools for plotting data by Greg Warnes et al
r-cran-gregmisc - Greg Warnes らによる雑多な GNU R 関数パッケージ
r-cran-gtools - Greg Warnes などによる R プログラミングツール付き GNU R パッケージ
r-cran-haplo.stats - ハプロタイプ分析用 GNU R パッケージ
r-cran-kernsmooth - GNU R package for kernel smoothing and density estimation
r-cran-lattice - GNU R package for 'Trellis' graphics
r-cran-littler - GNU R スクリプト言語およびコマンドラインフロントエンド
r-cran-mapdata - GNU R 用地図描画サポート (追加データ)
r-cran-mgcv - GNU R package for multiple parameter smoothing estimation
r-cran-mnp - 多項プロフィット (MNP) モデル適合用 GNU R パッケージ
r-cran-mvtnorm - 多変量の通常および T 分布計算用 GNU R パッケージ
r-cran-nlme - GNU R package for (non-)linear mixed effects models
r-cran-pscl - 離散データモデル用 GNU R パッケージ
r-cran-quadprog - 2 次計画問題を解決するための GNU R パッケージ
r-cran-rgl - OpenGL を用いた三次元の可視化用 GNU R パッケージ
r-cran-rmpi - 分散コンピューティング用に MPI ライブラリとインターフェイスする GNU R パッケージ
r-cran-rpart - GNU R package for recursive partitioning and regression trees
r-cran-rsprng - SPRNG (Scalable Parallel RNGs) の GNU R インターフェース
r-cran-survival - GNU R package for survival analysis
r-cran-vcd - GNU R カテゴリデータの可視化
r-cran-xml - XML 解析および生成用 GNU R パッケージ
r-cran-zelig - 統計モデル評価用の統合化されたフロントエンドを供給する GNU R パッケージ
r-doc-html - GNU R html manuals for statistical computing system
r-doc-info - GNU R info manuals statistical computing system
r-doc-pdf - GNU R pdf manuals for statistical computing system
r-mathlib - GNU R standalone mathematics library
r-recommended - GNU R collection of recommended packages [metapackage]
rubber - automated system for building LaTeX documents
r-cran-ade4 - GNU R analysis of ecological data
r-cran-adegenet - GNU R exploratory analysis of genetic and genomic data
r-cran-adegraphics - GNU R lattice-based package for the representation of multivariate data
r-cran-adephylo - GNU R exploratory analyses for the phylogenetic comparative method
r-cran-aer - Applied Econometrics with R
r-cran-afex - GNU R package for analyzing factorial experiments using ANOVA or mixed models
r-cran-alakazam - Immunoglobulin Clonal Lineage and Diversity Analysis
r-cran-amelia - GNU R package supporting multiple imputation of missing data
r-cran-amore - GNU R: A MORE flexible neural network package
r-cran-animation - GNU R gallery of animations and utilities to create animations
r-cran-ape - GNU R package for Analyses of Phylogenetics and Evolution
r-cran-aplpack - Another Plot PACKage: stem.leaf, bagplot, faces, spin3R and others
r-cran-arm - Data Analysis Using Regression and Multilevel/Hierarchical Models
r-cran-askpass - safe password entry for GNU R, Git, and SSH
r-cran-assertthat - GNU R easy pre and post assertions
r-cran-backports - reimplementation of functions introduced since R-3.0.0
r-cran-base64enc - GNU R package that provides tools for base64 encoding
r-cran-base64url - GNU R fast and URL-safe Base64 encoder and decoder
r-cran-batchjobs - GNU R batch computing
r-cran-batchtools - GNU R tools for computation on batch systems
r-cran-bayesfactor - GNU R Bayes factors for t-tests, ANOVAs and contingency tables
r-cran-bayesplot - GNU R plotting for bayesian models
r-cran-bbmisc - GNU R Miscellaneous helper functions for B. Bischl
r-cran-bbmle - GNU R tools for general maximum likelihood estimation
r-cran-bdsmatrix - GNU R routines for block diagonal symmetric matrices
r-cran-beeswarm - bee swarm plot, an alternative to stripchart
r-cran-bh - (Virtual) GNU R package to provide BH
r-cran-biasedurn - GNU R Biased Urn model distributions
r-cran-bibtex - GNU R Bibtex Parser
r-cran-bigmemory - Manage Massive Matrices with Shared Memory and Memory-Mapped Files
r-cran-bigmemory.sri - Shared resource interface for Bigmemory Project packages
r-cran-bindr - Parametrized Active Bindings for GNU R
r-cran-bindrcpp - GNU R 'Rcpp' Interface to Active Bindings
r-cran-bio3d - GNU R package for biological structure analysis
r-cran-biocmanager - Access the Bioconductor Project Package Repository
r-cran-bit - GNU R class for vectors of 1-bit booleans
r-cran-bit64 - GNU R S3 Class for Vectors of 64bit Integers
r-cran-bitops - GNU R package implementing bitwise operations
r-cran-blme - GNU R Bayesian linear mixed-effects models
r-cran-blob - GNU R S3 Class for Representing Vectors of Binary Data ('BLOBS')
r-cran-blockmodeling - Generalized and classical blockmodeling of valued networks
r-cran-bms - GNU R package for Bayesian model averaging for linear models
r-cran-bold - GNU R interface to Bold Systems for genetic barcode data
r-cran-boolnet - assembling, analyzing and visualizing Boolean networks
r-cran-bradleyterry2 - GNU R package for using Bradley-Terry models
r-cran-brew - GNU R templating framework for report generation
r-cran-brglm - GNU R package for bias reduction in binomial-response GLMs
r-cran-bridgesampling - GNU R bridge sampling for marginal likelihoods and Bayes factors
r-cran-brobdingnag - Very Large Numbers in R
r-cran-broom - convert statistical analysis objects into tidy data frames with GNU R
r-cran-ca - GNU R package for simple, multiple and joint correspondence analysis
r-cran-cairo - GNU R graphics device using cairo graphics library
r-cran-cairodevice - GNU R Cairo/Gtk2 device driver package
r-cran-calibrate - Calibration of Scatterplot and Biplot Axes
r-cran-callr - Call GNU R from GNU R
r-cran-cardata - GNU R package for datasets for Companion to Applied Regression
r-cran-caret - GNU R package for classification and regression training
r-cran-catools - GNU R package providing various utility functions
r-cran-cellranger - GNU R package to map spreadsheet cell ranges to rows and columns
r-cran-checkmate - GNU R fast and versatile argument checks
r-cran-chron - GNU R package for chronologically ordered objects
r-cran-circlize - Circular Visualization
r-cran-class - GNU R package for classification
r-cran-classint - GNU R Choose Univariate Class Intervals
r-cran-cli - GNU R helpers for developing command line interfaces
r-cran-cliapp - create rich command line applications in GNU R
r-cran-clipr - Read and Write from the System Clipboard
r-cran-clisymbols - Unicode Symbols at the R Prompt
r-cran-clustergeneration - GNU R random cluster generation (with specified degree of separation)
r-cran-cmprsk - GNU R subdistribution analysis of competing risks
r-cran-coin - GNU R package providing conditional inference procedures
r-cran-colorspace - GNU R Color Space Manipulation
r-cran-colourpicker - GNU R colour picker tool for selecting colours in plots
r-cran-combinat - GNU R package with utilities for combinatorics
r-cran-commonmark - high performance CommonMark and Github markdown rendering in R
r-cran-contfrac - GNU R package providing various utilities for evaluating continued fractions
r-cran-conting - GNU R package for Bayesian analysis of contingency tables
r-cran-corpcor - GNU R for Estimation of Covariance and Correlation -- corpcor
r-cran-crayon - GNU R colored terminal output
r-cran-crosstalk - GNU R inter-widget interactivity for HTML widgets
r-cran-crul - simple HTTP Client for GNU R
r-cran-cubature - GNU R package for adaptive multivariate integration
r-cran-curl - GNU R modern and flexible web client for R
r-cran-cvst - GNU R fast cross-validation via sequential testing
r-cran-data.table - GNU R extension of Data.frame
r-cran-date - GNU R package for date handling
r-cran-dbi - GNU R package providing a generic database interface
r-cran-dbitest - GNU R testing 'DBI' back ends
r-cran-dbplyr - GNU R dplyr back end for databases
r-cran-ddalpha - GNU R depth-based classification and calculation of data depth
r-cran-deal - Learning Bayesian Networks with Mixed Variables
r-cran-deldir - GNU R Delaunay Triangulation and Dirichlet (Voronoi) Tessellation
r-cran-dendextend - Extending 'dendrogram' Functionality in GNU R
r-cran-deoptimr - GNU R package for Diffential Evolution in pure R
r-cran-desc - GNU R manipulation of DESCRIPTION files
r-cran-desolve - GNU R package providing functions that solve initial value problems
r-cran-devtools - Tools to Make Developing R Packages Easier
r-cran-diagnosismed - medical diagnostic test accuracy analysis toolkit
r-cran-dichromat - GNU R color schemes for dichromats
r-cran-digest - GNU R package for 'hash digest' of R data structures
r-cran-dimred - GNU R framework for dimensionality reduction
r-cran-diptest - Hartigan's Dip Test Statistic for Unimodality - Corrected
r-cran-distory - GNU R distance between phylogenetic histories
r-cran-domc - GNU R parallel excution backend for %dopar% using multicore
r-cran-doparallel - GNU R foreach parallel adaptor for the parallel package
r-cran-dorng - GNU R generic reproducible parallel backend for 'foreach' loops
r-cran-dosefinding - Planning and Analyzing Dose Finding experiments
r-cran-dosnow - GNU R parallel excution backend for %dopar% using snow
r-cran-dotcall64 - Enhanced Foreign Function Interface Supporting Long Vectors
r-cran-downloader - GNU R package for downloading files over http and https
r-cran-dplyr - GNU R grammar of data manipulation
r-cran-drr - GNU R dimensionality reduction via regression
r-cran-dt - GNU R wrapper of the JavaScript library 'DataTables'
r-cran-dygraphs - GNU R interface to 'Dygraphs' interactive time series charting library
r-cran-dynlm - GNU R package for dynamic linear models and time series regression
r-cran-e1071 - GNU R package with miscellaneous functions of the Dept of Statisics (e1071)
r-cran-eaf - GNU R plots of the empirical attainment function
r-cran-earth - GNU R multivariate adaptive regression splines
r-cran-eco - GNU R routines for Bayesian ecological inference
r-cran-ecodist - GNU R package for dissimilarity-based ecological analysis
r-cran-effects - GNU R graphical and tabular effects display for glm models
r-cran-ei - GNU R ecological inference
r-cran-eipack - GNU R ecological inference and higher-dimension data management
r-cran-ellipse - GNU R functions for drawing ellipses and ellipse-like confidence regions
r-cran-elliptic - GNU R package providing elliptic and related functions
r-cran-emmeans - GNU R estimated marginal means, aka least-squares means
r-cran-emoa - GNU R evolutionary multiobjective optimization algorithms
r-cran-energy - GNU R package for energy statistics for distribution comparison
r-cran-epi - GNU R epidemiological analysis
r-cran-epibasix - GNU R Elementary Epidemiological Functions
r-cran-epicalc - GNU R Epidemiological calculator
r-cran-epir - GNU R Functions for analysing epidemiological data
r-cran-epitools - GNU R Epidemiology Tools for Data and Graphics
r-cran-erm - GNU R package for 'extended Rasch modelling'
r-cran-estimability - GNU R package providing tools for determining estimability of linear functions
r-cran-etm - GNU R empirical transition matrix
r-cran-evaluate - GNU R parsing and evaluation tools
r-cran-expm - GNU R Computation of the matrix exponential and related quantities
r-cran-extradistr - additional univariate and multivariate distributions for GNU R
r-cran-factominer - Multivariate Exploratory Data Analysis and Data Mining
r-cran-fail - GNU R File Abstraction Interface Layer (FAIL) mimicking a key-value store
r-cran-fansi - GNU R ANSI control sequence aware string functions
r-cran-fassets - GNU R package for financial engineering -- fAssets
r-cran-fastcluster - Fast hierarchical clustering routines for GNU R
r-cran-fastica - GNU R package for ICA and Projection Pursuit
r-cran-fastmatch - GNU R package for fast match replacement for repeated look-ups
r-cran-fauxpas - GNU R HTTP error helpers
r-cran-fbonds - GNU R package for financial engineering -- fBonds
r-cran-ffield - Force field simulation for a set of points
r-cran-fgarch - GNU R package for financial engineering -- fGarch
r-cran-fields - GNU R tools for spatial data
r-cran-filehash - GNU R simple key-value database
r-cran-fimport - GNU R package for financial engineering -- fImport
r-cran-fitbitscraper - Import your Fitbit data from the Fitbit's website into R
r-cran-fitcoach - R package for analysis and retrieve data of Fitbit
r-cran-flashclust - Implementation of optimal hierarchical clustering
r-cran-flexmix - GNU R flexible mixture modeling
r-cran-fnn - GNU R fast nearest neighbor search algorithms and applications
r-cran-fnonlinear - GNU R package for financial engineering -- fNonlinear
r-cran-forcats - GNU R package for working with categorical variables (factors)
r-cran-foreach - GNU R foreach looping support
r-cran-formatr - Format R code automatically
r-cran-formula - GNU R package for extended model formulas
r-cran-fpc - GNU R flexible procedures for clustering
r-cran-fregression - GNU R package for financial engineering -- fRegression
r-cran-fs - GNU R cross-platform file system operations
r-cran-ftrading - GNU R package for financial engineering -- fTrading
r-cran-fts - GNU R interface to tslib
r-cran-funitroots - GNU R package for financial engineering -- fUnitRoots
r-cran-futile.logger - logging utility for GNU R
r-cran-futile.options - GNU R futile options management
r-cran-future - R package: A Future API for R
r-cran-g.data - GNU R package for delayed-data
r-cran-gam - Generalized Additive Models for R
r-cran-gbm - GNU R package providing Generalized Boosted Regression Models
r-cran-gclus - GNU R clustering graphics
r-cran-gdtools - GNU R utilities for graphical rendering
r-cran-gee - Generalized Estimation Equation Solver
r-cran-geepack - Generalized Estimating Equation Package for R
r-cran-genabel - GNU R package for genome-wide SNP association analysis
r-cran-genabel.data - data package for genome-wide SNP association analysis
r-cran-generics - GNU R common S3 generics not provided by base R methods
r-cran-geometry - GNU R mesh generation and surface tesselation
r-cran-geosphere - GNU R Spherical Trigonometry
r-cran-getopt - GNU R package providing command-line parsing functionality
r-cran-ggally - GNU R extension to r-cran-ggplot2
r-cran-ggeffects - GNU R create tidy data frames of marginal effects for 'ggplot'
r-cran-ggplot2 - implementation of the Grammar of Graphics
r-cran-ggridges - Ridgeline Plots in 'ggplot2'
r-cran-ggsci - Scientific Journal and Sci-Fi Themed Color Palettes
r-cran-ggvis - GNU R interactive grammar of graphics
r-cran-gh - GNU R Minimal client to access the 'GitHub' 'API'
r-cran-git2r - GNU R access to Git repositories
r-cran-glmmtmb - Generalized Linear Mixed Models using Template Model Builder
r-cran-glmnet - Lasso and Elastic-Net Regularized Generalized Linear Models
r-cran-globaloptions - Generate Functions to Get or Set Global Options
r-cran-globals - R package: Identify Global Objects in R Expressions
r-cran-glue - GNU R interpreted string literals
r-cran-gmaps - GNU R support for producing geographic maps with grid graphics
r-cran-gmm - GNU R generalized method of moments and generalized empirical likelihood
r-cran-gnm - GNU R package for generalized nonlinear models
r-cran-goftest - GNU R Classical Goodness-of-Fit Tests for Univariate Distributions
r-cran-googlevis - GNU R Interface to Google Charts
r-cran-gower - GNU R Gower's Distance
r-cran-gridbase - GNU R Integration of base and grid graphics
r-cran-gridextra - GNU R package with extensions for the grid package
r-cran-gsa - GNU R gene set analysis
r-cran-gsl - GNU R wrapper for the GNU Scientific Library
r-cran-gss - GNU R package for multivariate estimation using smoothing splines
r-cran-gtable - Arrange grobs in tables
r-cran-guerry - maps, data and methods related to Guerry moral statistics
r-cran-haven - GNU R package to import/export SPSS, Stata and SAS files
r-cran-hdf5 - GNU R package interfacing the NCSA HDF5 library
r-cran-heatmaply - GNU R interactive cluster heat maps using 'plotly'
r-cran-hexbin - GNU R hexagonal binning routines
r-cran-highr - Syntax Highlighting for R Source Code
r-cran-hmisc - GNU R miscellaneous functions by Frank Harrell
r-cran-hms - GNU R pretty time of day
r-cran-htmltable - GNU R package for advanced html tables
r-cran-htmltools - GNU R tools for HTML
r-cran-htmlwidgets - GNU R HTML Widgets
r-cran-httpcode - GNU R HTTP Status Code Helper
r-cran-httpuv - GNU R package of HTTP and WebSocket Server Library
r-cran-httr - GNU R tools for working with URLs and HTTP
r-cran-hwriter - HTML Writer - Outputs R objects in HTML format
r-cran-hypergeo - GNU R package providing the Gaussian hypergeometric for complex numbers
r-cran-igraph - GNU R network analysis and visualization
r-cran-ini - Read and Write '.ini' Files
r-cran-inline - GNU R package to inline C, C++, Fortran functions from R
r-cran-int64 - GNU R package for 64 bit integer types
r-cran-interp - GNU R interpolation methods
r-cran-ipred - GNU R improved predictors
r-cran-irace - GNU R iterated racing for automatic algorithm configuration
r-cran-irlba - GNU R fast truncated SVD, PCA and symmetric eigendecomposition
r-cran-iso - GNU R functions to perform isotonic regression
r-cran-isocodes - GNU R package providing tables for several ISO codes
r-cran-isospec - Isotopic fine structure calculator for GNU R
r-cran-isoweek - GNU R week of the year and weekday according to ISO 8601
r-cran-iterators - GNU R iterator support for vectors, lists and other containers
r-cran-its - GNU R package for handling irregular time series
r-cran-jsonld - GNU R JSON for linking data
r-cran-jsonlite - Robust, High Performance JSON Parser and Generator for R
r-cran-kedd - Kernel Estimator+Bandwidth Selection - Density+Derivatives
r-cran-kernlab - GNU R package for kernel-based machine learning lab
r-cran-kmi - GNU R Kaplan-Meier Multiple Imputation
r-cran-knitr - GNU R package for dynamic report generation using Literate Programming
r-cran-labeling - GNU R Axis Labeling optimization
r-cran-lambda.r - GNU R modeling data with functional programming
r-cran-later - GNU R utilities for delaying function execution
r-cran-latticeextra - GNU R package of additional graphical displays based on lattice
r-cran-lava - GNU R latent variable models
r-cran-lavaan - GNU R package for latent variable analysis -- lavaan
r-cran-lazyeval - GNU R lazy (non-standard) evaluation
r-cran-leaps - Regression Subset Selection
r-cran-learnbayes - GNU R functions for learning bayesian inference
r-cran-lexrankr - extractive summarization of text with the LexRank algorithm
r-cran-lhs - GNU R Latin Hypercube Samples
r-cran-libcoin - GNU R linear test statistics for permutation inference
r-cran-listenv - R package: Environments Behaving (Almost) as Lists
r-cran-lme4 - GNU R package for linear mixed effects model fitting
r-cran-lmertest - GNU R tests in Linear Mixed Effects Models
r-cran-lmtest - GNU R package for diagnostic checking in linear models
r-cran-logspline - GNU R package providing routines for the logspline density estimation
r-cran-loo - GNU R leave-one-out cross-validation and WAIC for Bayesian models
r-cran-lpsolve - GNU R package providing linear program solvers
r-cran-lsmeans - GNU R package providing least-squares means for various classes of models
r-cran-lubridate - simplifies dealing with dates in R
r-cran-luminescence - GNU R comprehensive luminescence dating data analysis
r-cran-lwgeom - GNU R bindings to selected 'liblwgeom' functions for simple features
r-cran-magic - GNU R create and investigate magic squares
r-cran-magick - advanced graphics and image-processing in GNU R
r-cran-magrittr - GNU R forward-pipe operator
r-cran-maldiquant - GNU R package for quantitative analysis of mass spectrometry data
r-cran-maldiquantforeign - GNU R package providing import/export routines for MALDIquant
r-cran-manipulatewidgets - GNU R package for more interactivity in interactive charts
r-cran-mapproj - GNU R support for cartographic projections of map data
r-cran-maps - GNU R support for producing geographic maps
r-cran-maptools - GNU R Tools for reading and handling spatial objects
r-cran-maptree - GNU R mapping, pruning, and graphing tree models
r-cran-markdown - GNU R package providing R bindings to the Sundown Markdown rendering library
r-cran-mass - GNU R package of Venables and Ripley's MASS
r-cran-matching - multivariate and propensity score matching with balance optimization
r-cran-matchit - GNU R package of nonparametric matching methods
r-cran-matrix - GNU R package of classes for dense and sparse matrices
r-cran-matrixcalc - GNU R functions for matrix calculations -- matrixcalc
r-cran-matrixmodels - GNU R package for sparse and dense matrix models
r-cran-matrixstats - GNU R methods that apply to rows and columns of a matrix
r-cran-maxlik - GNU R maximum likelihood estimation
r-cran-mclust - Gaussian Mixture Modelling for Model-Based Clustering
r-cran-mcmc - GNU R package for Markov Chain Monte Carlo simulations
r-cran-mcmcpack - R routines for Markov chain Monte Carlo model estimation
r-cran-mda - GNU R mixture and flexible discriminant analysis
r-cran-medadherence - GNU R Medication Adherence: Commonly Used Definitions
r-cran-memoise - Memoise functions
r-cran-mertools - GNU R tools for analyzing mixed effect regression models
r-cran-metamix - GNU R bayesian mixture analysis for metagenomic community profiling
r-cran-metrics - GNU R evaluation metrics for machine learning
r-cran-mfilter - GNU R package providing miscellaneous time series filters
r-cran-mi - GNU R package for Missing Data Imputation and Model Checking -- mi
r-cran-mime - R package which maps filenames to MIME Types
r-cran-miniui - Shiny UI Widgets for Small Screens
r-cran-minpack.lm - GNU R Levenberg-Marquardt nonlinear least-squares algorithm found in MINPACK
r-cran-minqa - GNU R package for quadratic optimisation without derivatives
r-cran-misc3d - GNU R collection of 3d plot functions and rgl-based isosurfaces
r-cran-misctools - GNU R miscellaneous tools and utilities
r-cran-mitools - GNU R tools for multiple imputation of missing data
r-cran-mixtools - GNU R tools for analyzing finite mixture models
r-cran-mlbench - GNU R Machine Learning Benchmark Problems
r-cran-mlmetrics - GNU R machine learning evaluation metrics
r-cran-mlmrev - GNU R Examples from Multilevel Modelling Software Review
r-cran-mlr - Machine learning in GNU R
r-cran-mnormt - GNU R package providing multivariate normal and t distribution
r-cran-mockery - mocking library for GNU R
r-cran-mockr - mocking in GNU R
r-cran-modelmetrics - GNU R Rapid Calculation of Model Metrics
r-cran-modelr - GNU R modelling functions that work with the pipe
r-cran-modeltools - GNU R package providing a collection of tools to deal with statistical models
r-cran-msm - GNU R Multi-state Markov and hidden Markov models in continuous time
r-cran-multcomp - GNU R package for multiple comparison procedures
r-cran-multcompview - GNU R visualizations of paired comparisons
r-cran-multicore - GNU R parallel processing on multi-core or multi-cpu machines
r-cran-munsell - Utilities for using Munsell colors
r-cran-mvnormtest - GNU R package for multivariate normality test
r-cran-natserv - GNU R 'NatureServe' Interface
r-cran-ncdf4 - GNU R interface to Unidata netCDF format data files
r-cran-ncmeta - GNU R Straightforward 'NetCDF' Metadata
r-cran-nleqslv - GNU R package for solving systems of nonlinear equations
r-cran-nloptr - GNU R package for interface to NLopt
r-cran-nlp - Natural Language Processing Infrastructure for R
r-cran-nmf - GNU R framework to perform non-negative matrix factorization
r-cran-nnet - GNU R package for feed-forward neural networks
r-cran-nnls - GNU R package for non-negative least squares (the Lawson-Hanson algorithm)
r-cran-nortest - GNU R package with five tests for normality
r-cran-numderiv - GNU R package for accurate numerical derivatives
r-cran-nws - GNU R package for distributed programming via NetWorkSpaces
r-cran-openssl - GNU R toolkit for encryption, signatures and certificates based on OpenSSL
r-cran-openxlsx - GNU R package to read and write XLSX files
r-cran-optparse - GNU/R Command line option parser
r-cran-parallelmap - GNU R unified interface to parallelization back-ends
r-cran-paramhelpers - GNU R helpers for parameters in black-box optimization and tuning
r-cran-pbapply - GNU R package providing progress bars for vectorized R functions
r-cran-pbdzmq - R bindings for ZeroMQ from the pbdR project
r-cran-pbivnorm - GNU R package for calculating probabilities from a bivariate normal CDF
r-cran-pbkrtest - GNU R package for tests in linear mixed-effect models
r-cran-pbmcapply - GNU R tracking the progress of Mc*pply with progress bar
r-cran-permute - R functions for generating restricted permutations of data
r-cran-phangorn - GNU R package for phylogenetic analysis
r-cran-pheatmap - GNU R package to create pretty heatmaps
r-cran-phylobase - GNU R base package for phylogenetic structures and comparative data
r-cran-phytools - GNU R phylogenetic tools for comparative biology
r-cran-pillar - GNU R coloured formatting for columns
r-cran-pkgbuild - find tools needed to build GNU R packages
r-cran-pkgconfig - Private Configuration for 'R' Packages
r-cran-pkgkitten - GNU R package to create simple packages
r-cran-pkgload - simulate GNU R package installation and attach
r-cran-pkgmaker - GNU R package development utilities
r-cran-pki - public key infrastucture for R based on the X.509 standard
r-cran-plm - GNU R estimators and tests for panel data econometrics
r-cran-plogr - GNU R C++ Logging Library
r-cran-plotly - create interactive web graphics via 'plotly.js' in GNU R
r-cran-plotmo - GNU R plot a model's response and residuals
r-cran-plotrix - GNU R package providing various plotting functions
r-cran-pls - GNU R partial least squares and principal component regression
r-cran-plumber - API Generator for GNU R
r-cran-plyr - tools for splitting, applying and combining data
r-cran-png - GNU R package to read and write PNG images
r-cran-polspline - GNU R package providing polynomial spline fitting
r-cran-polyclip - GNU R Polygon Clipping
r-cran-polycub - GNU R Cubature over Polygonal Domains
r-cran-popepi - Functions for Epidemiological Analysis using Population Data
r-cran-powerlaw - GNU R analysis of heavy tailed distributions
r-cran-prabclus - GNU R clustering of presence-absence, abundance and multilocus genetic data
r-cran-pracma - practical numerical math functions for GNU R
r-cran-praise - GNU R praise users
r-cran-prediction - GNU R tidy, type-safe 'prediction()' methods
r-cran-prettycode - pretty print GNU R code in the terminal
r-cran-prettyr - Pretty Descriptive Stats
r-cran-prettyunits - GNU R pretty, human readable formatting of quantities
r-cran-princurve - fit a principal curve in arbitrary dimension
r-cran-processx - GNU R execute and control system processes
r-cran-prodlim - GNU R product-limit estimation for Censored Event History Analysis
r-cran-profilemodel - GNU R tools for profiling inference functions
r-cran-progress - GNU R terminal progress bars
r-cran-promises - GNU R abstractions for promise-based asynchronous programming
r-cran-proto - Prototype object-based programming
r-cran-ps - GNU R list, query, manipulate system processes
r-cran-pscbs - R package: Analysis of Parent-Specific DNA Copy Numbers
r-cran-psy - GNU R procedures for psychometrics
r-cran-psych - GNU R procedures for psychological, psychometric, and personality research
r-cran-purrr - GNU R functional programming tools
r-cran-purrrlyr - GNU R Tools at the Intersection of 'purrr' and 'dplyr'
r-cran-pvclust - Hierarchical Clustering with P-Values via Multiscale Bootstrap
r-cran-pwr - GNU R basic functions for power analysis
r-cran-pwt - GNU R package for the Penn World Tables (version 5.6 to 7.1)
r-cran-pwt8 - GNU R package for the Penn World Tables (version 8.x)
r-cran-pwt9 - GNU R package for the Penn World Tables (version 9.x)
r-cran-qap - GNU R heuristics for the quadratic assignment problem (QAP)
r-cran-qqman - R package for visualizing GWAS results using Q-Q and manhattan plots
r-cran-qtl - GNU R package for genetic marker linkage analysis
r-cran-quantmod - GNU R package for quantitative financial modeling framework
r-cran-quantreg - GNU R package for quantile regression
r-cran-qvcalc - GNU R quasi variances for factor effects in statistical models
r-cran-r.cache - R package: Fast and Light-Weight Caching of Objects and Results
r-cran-r.methodss3 - GNU R utility function for defining S3 methods
r-cran-r.oo - GNU R object-oriented programming with or without references
r-cran-r.utils - GNU R various programming utilities
r-cran-r6 - R classes with reference semantics
r-cran-randomfields - GNU R simulation and analysis of random fields
r-cran-randomfieldsutils - utilities for the simulation and analysis of random fields
r-cran-randomforest - GNU R package implementing the random forest classificator
r-cran-ranger - Fast Implementation of Random Forests
r-cran-rappdirs - GNU R application directories
r-cran-raschsampler - GNU R package for sampling binary matrices with fixed margins
r-cran-raster - GNU R geographic data analysis and modeling
r-cran-rcarb - GNU R dose rate modelling of carbonate-rich samples
r-cran-rcmdcheck - Run 'R CMD check' from 'R' and Capture Results
r-cran-rcmdr - GNU R platform-independent basic-statistics GUI
r-cran-rcmdrmisc - GNU R package for miscellaneous Rcmdr utilities
r-cran-rcolorbrewer - GNU R package providing suitable color palettes
r-cran-rcpp - GNU R package for Seamless R and C++ Integration
r-cran-rcppannoy - Rcpp bindings for Annoy (approximate nearest neighbors)
r-cran-rcpparmadillo - GNU R package for Armadillo C++ linear algebra library
r-cran-rcppeigen - GNU R package for Eigen templated linear algebra
r-cran-rcppgsl - GNU R package for integration with the GNU GSL
r-cran-rcppprogress - interruptible progress bar for C++ in GNU R packages
r-cran-rcpproll - GNU R efficient rolling / windowed operations
r-cran-rcurl - GNU R General network (HTTP/FTP/...) client interface
r-cran-rdflib - GNU R tools to manipulate and query semantic data
r-cran-readbrukerflexdata - GNU R package to read Bruker Daltonics *flex format files
r-cran-readmzxmldata - GNU R package to read mass spectrometry data in mzXML format
r-cran-readr - GNU R package to read rectangular text data
r-cran-readstata13 - GNU R package to import 'Stata' data files
r-cran-readxl - GNU R package to read Excel files
r-cran-recipes - GNU R preprocessing tools to create design matrices
r-cran-redland - RDF library bindings in GNU R
r-cran-registry - GNU R package for registries
r-cran-relimp - GNU R package for inference on relative importance of regressors
r-cran-relsurv - GNU R relative survival
r-cran-rematch - GNU R package to match regular expression with a nicer api
r-cran-remotes - R Package Installation from Remote Repositories, Including 'GitHub'
r-cran-rentrez - GNU R interface to the NCBI's EUtils API
r-cran-repr - Serializable representations of R objects
r-cran-reprex - Prepare Reproducible Example Code via the Clipboard
r-cran-reshape - Flexibly reshape data
r-cran-reshape2 - Flexibly reshape data: a reboot of the reshape package
r-cran-reticulate - R interface to Python modules, classes, and functions
r-cran-rgenoud - R Version of GENetic Optimization Using Derivatives
r-cran-rggobi - GNU R package for the GGobi data visualization system
r-cran-rglpk - GNU R interface to the GNU Linear Programming Kit
r-cran-rglwidget - GNU R 'rgl' in 'htmlwidgets' Framework
r-cran-rgtk2 - GNU R binding for Gtk2
r-cran-rhandsontable - GNU R interface to the 'Handsontable.js' library
r-cran-rinside - GNU R package to embed R in C++ application
r-cran-rio - GNU R package with Swiss-army knife for data i/o
r-cran-ritis - GNU R Integrated Taxonomic Information System client
r-cran-rjags - R interface to the JAGS Bayesian statistics package
r-cran-rjava - GNU R low-level interface to Java
r-cran-rjson - GNU R package for converting between R and JSON objects
r-cran-rlang - Functions for Base Types and Core R and 'Tidyverse' Features
r-cran-rlist - GNU R toolbox for non-tabular data manipulation
r-cran-rlumshiny - GNU R 'Shiny' Applications for the R Package 'Luminescence'
r-cran-rmarkdown - convert R markdown documents into a variety of formats
r-cran-rms - GNU R regression modeling strategies by Frank Harrell
r-cran-rmysql - GNU R package providing a DBI-compliant interface to MySQL
r-cran-rncl - GNU R interface to the Nexus Class Library
r-cran-rneos - GNU R package with XML-RPC interface to NEOS
r-cran-rnetcdf - GNU R package that provides an R interface to NetCDF datasets
r-cran-rnexml - GNU R package for semantically rich I/O for the 'NeXML' format
r-cran-rngtools - GNU R package for random number generators
r-cran-rniftilib - GNU/R interface to NIFTICLIB
r-cran-robustbase - GNU R package providing basic robust statistics
r-cran-rocr - GNU R package to prepare and display ROC curves
r-cran-rodbc - GNU R package for ODBC database access
r-cran-rotl - GNU R interface to the 'Open Tree of Life' API
r-cran-roxygen2 - in-line documentation for GNU R
r-cran-rpact - Confirmatory Adaptive Clinical Trial Design and Analysis
r-cran-rpostgresql - GNU R package providing database interface and driver for PostgreSQL
r-cran-rprojroot - GNU R finding files in project subdirectories
r-cran-rprotobuf - GNU R package providing an interface to the Protocol Buffers API
r-cran-rquantlib - GNU R package interfacing the QuantLib finance library
r-cran-rredlist - GNU R IUCN Red List Client
r-cran-rsclient - GNU R package providing an Rserve client
r-cran-rsdmx - GNU R package for the Statistical Data and Metadata Exchange (SDMX) framework
r-cran-rserve - GNU R Rserve tcp/ip server and sample clients
r-cran-rsolnp - GNU R general non-linear optimization
r-cran-rspectra - GNU R solvers for large-scale eigenvalue and SVD problems
r-cran-rsqlite - Database Interface R driver for SQLite
r-cran-rstan - GNU R interface to Stan
r-cran-rstantools - tools for developing GNU R packages interfacing with 'Stan'
r-cran-rstudioapi - GNU R package for access to the RStudio API
r-cran-rsymphony - GNU R interface to the SYMPHONY MILP solver
r-cran-rtsne - GNU R T-Distributed Stochastic Neighbor Embedding using a Barnes-Hut
r-cran-runit - GNU R package providing unit testing framework
r-cran-rvest - Easily Harvest (Scrape) Web Pages
r-cran-rwave - GNU R time-frequency analysis of 1-D signals
r-cran-samr - GNU R significance analysis of microarrays
r-cran-sandwich - GNU R package for model-robust standard error estimates
r-cran-satellite - GNU R handling and manipulating remote sensing data
r-cran-scales - Scale functions for visualization
r-cran-scatterd3 - GNU R D3 JavaScript Scatterplot from R
r-cran-scatterplot3d - GNU R package for Visualizing Multivariate Data
r-cran-sdmtools - Species Distribution Modelling Tools
r-cran-segmented - GNU R segmented relationships in regression models
r-cran-selectr - Translate CSS Selectors to XPath Expressions
r-cran-sem - GNU R functions for fitting structural equation models -- sem
r-cran-semtools - GNU R Tools for Structural Equation Modeling -- semTools
r-cran-sendmailr - send email using GNU R
r-cran-seqinr - GNU R biological sequences retrieval and analysis
r-cran-seriation - GNU R infrastructure for ordering objects using seriation
r-cran-seroincidence - GNU R seroincidence calculator tool
r-cran-sessioninfo - R Session Information
r-cran-sf - Simple Features for R
r-cran-sfsmisc - GNU R utilities from 'Seminar fuer Statistik' ETH Zurich
r-cran-shape - GNU R functions for plotting graphical shapes, colors
r-cran-shazam - Immunoglobulin Somatic Hypermutation Analysis
r-cran-shiny - GNU R web application framework
r-cran-shinybs - GNU R Twitter bootstrap components for Shiny
r-cran-shinydashboard - GNU R create dashboards with 'Shiny'
r-cran-shinyfiles - GNU R server-side file system viewer for shiny
r-cran-shinyjs - Easily Improve the User Experience of Your Shiny Apps in Seconds
r-cran-shinythemes - Themes for Shiny
r-cran-sjlabelled - GNU R labelled data utility functions
r-cran-sjmisc - GNU R data and variable transformation functions
r-cran-sjplot - GNU R data visualization for statistics in social science
r-cran-sjstats - GNU R collection of convenient functions for statistical computations
r-cran-slam - GNU R sparse lighweight arrays and matrices package
r-cran-sm - GNU R package for kernel smoothing methods
r-cran-sn - GNU R package providing skew-normal and skew-t distributions
r-cran-snakecase - convert strings into any case for GNU R
r-cran-snow - GNU R package for 'simple network of workstations'
r-cran-snowballc - Snowball stemmers based on the C libstemmer UTF-8 library
r-cran-snowfall - GNU R easier cluster computing (based on snow)
r-cran-solrium - general purpose R interface to 'Solr'
r-cran-sourcetools - tools for reading, tokenizing and parsing R code
r-cran-sp - GNU R classes and methods for spatial data
r-cran-spam - GNU R functions for sparse matrix algebra
r-cran-sparsem - GNU R package for basic linear algebra for sparse matrices
r-cran-spatial - GNU R package for spatial statistics
r-cran-spatstat - GNU R Spatial Point Pattern analysis, model-fitting, simulation, tests
r-cran-spatstat.data - datasets for the package r-cran-spatstat
r-cran-spatstat.utils - GNU R utility functions for r-cran-spatstat
r-cran-spc - GNU R Statistical Process Control
r-cran-spdata - GNU R datasets for spatial analysis
r-cran-spdep - GNU R spatial dependence: weighting schemes, statistics and models
r-cran-spp - GNU R ChIP-seq processing pipeline
r-cran-squarem - Squared Extrapolation Methods for Accelerating EM-Like Monotone Algorithms
r-cran-stabledist - GNU R package for stable distribution functions
r-cran-stanheaders - C++ Header Files for Stan for GNU R
r-cran-stars - scalable, spatiotemporal tidy arrays for GNU R
r-cran-statmod - GNU R package providing algorithms and functions for statistical modeling
r-cran-stringdist - GNU R approximate string matching and string distance functions
r-cran-stringi - GNU R character string processing facilities
r-cran-stringr - Make it easier to work with strings
r-cran-strucchange - GNU R package for structural change regression estimation
r-cran-survey - GNU R analysis of complex survey samples
r-cran-svglite - GNU R 'SVG' graphics device
r-cran-sys - Powerful and Reliable Tools for Running System Commands in GNU R
r-cran-taxize - GNU R taxonomic information from around the web
r-cran-tcltk2 - GNU R package for Tcl/Tk additions
r-cran-tcr - Advanced Data Analysis of Immune Receptor Repertoires
r-cran-teachingdemos - GNU R Demonstrations for teaching and learning
r-cran-tensor - GNU R Tensor product of arrays
r-cran-testit - simple package for testing GNU R packages
r-cran-testthat - GNU R testsuite
r-cran-tfmpvalue - GNU R P-Value Computation for Position Weight Matrices
r-cran-tgp - GNU R Bayesian treed Gaussian process models
r-cran-th.data - GNU R package for datasets by Torsten Hothorn
r-cran-threejs - GNU R interactive 3D scatter plots, networks and globes
r-cran-tibble - GNU R Simple Data Frames
r-cran-tidyr - GNU R package to easily tidy data
r-cran-tidyselect - GNU R select from a set of strings
r-cran-tidyverse - Easily Install and Load the 'Tidyverse'
r-cran-tigger - Infers new Immunoglobulin alleles from Rep-Seq Data
r-cran-tikzdevice - GNU R graphics output in LaTeX format
r-cran-timedate - GNU R package for financial engineering -- timeDate
r-cran-timeseries - GNU R package for financial engineering -- timeSeries
r-cran-tinytex - GNU R helper to compile LaTeX documents
r-cran-tkrplot - GNU R embedded Tk plotting device package
r-cran-tm - Text Mining functionality for R
r-cran-tmb - GNU R template model builder: general random effect tool
r-cran-tmvtnorm - GNU R truncated multivariate normal and student t distribution
r-cran-treescape - GNU R Statistical Exploration of Landscapes of Phylogenetic Trees
r-cran-treespace - Statistical Exploration of Landscapes of Phylogenetic Trees
r-cran-triebeard - GNU R radix trees in Rcpp
r-cran-trimcluster - GNU R cluster analysis with trimming
r-cran-truncdist - GNU R functions for truncated random variables
r-cran-truncnorm - GNU R truncated normal distribution
r-cran-tseries - GNU R package for time-series analysis and comp. finance
r-cran-tsp - GNU R traveling salesperson problem (TSP)
r-cran-ttr - GNU R package to construct technical trading rules
r-cran-ucminf - GNU R general-purpose unconstrained non-linear optimization
r-cran-udunits2 - Udunits-2 Bindings for R
r-cran-units - Measurement Units for R Vectors
r-cran-urca - GNU R package providing unit root and cointegration tests
r-cran-urltools - GNU R vectorised tools for URL handling and parsing
r-cran-usethis - Automate Package and Project Setup
r-cran-utf8 - GNU R unicode text processing
r-cran-uuid - Tools for generating and handling UUIDs
r-cran-v8 - Embedded JavaScript Engine for R
r-cran-vcdextra - GNU R package providing extensions and additions to the vcd package
r-cran-vcr - GNU R record HTTP calls to disk
r-cran-vegan - Community Ecology Package for R
r-cran-vgam - GNU R package for estimating vector generalized additive models
r-cran-vioplot - GNU R toolbox for violin plots
r-cran-viridis - GNU R package for color maps from matplotlib
r-cran-viridislite - GNU R package for color maps from matplotlib (Lite Version)
r-cran-waveslim - GNU R wavelet routines for 1-, 2- and 3-D signal processing
r-cran-wavethresh - GNU R wavelets statistics and transforms
r-cran-wdi - GNU R package for accessing the World Development Indicators
r-cran-webmockr - GNU R stubbing and setting expectations on 'HTTP' requests
r-cran-webshot - GNU R take screenshots of web pages
r-cran-webutils - GNU R utility functions for developing web applications
r-cran-whatif - GNU R evaluate counterfactuals
r-cran-whisker - GNU R mustache, logicless templating
r-cran-wikidatar - GNU R API Client Library for 'Wikidata'
r-cran-wikipedir - GNU R MediaWiki API Wrapper
r-cran-wikitaxa - taxonomic information from 'Wikipedia' for GNU R
r-cran-withr - GNU R package to run code 'With' temporarily modified global state
r-cran-wordcloud - word clouds with GNU R
r-cran-worrms - GNU R client of World Register of Marine Species (WoRMS)
r-cran-xfun - miscellaneous GNU R functions by 'Yihui Xie'
r-cran-xml2 - GNU R XML parser
r-cran-xopen - Open System Files, 'URLs', Anything
r-cran-xslt - extensible style-sheet language transformations for GNU R
r-cran-xtable - GNU R coerce data to LaTeX and HTML tables
r-cran-xts - GNU R package for time series analysis -- xts
r-cran-yaml - Methods to convert R data to YAML and back
r-cran-zeligchoice - GNU R zelig choice models
r-cran-zeligei - GNU R zelig ecological inference models
r-cran-zeligverse - GNU R easily install and load stable zelig packages
r-cran-zip - GNU R package to read and write XLSX files
r-cran-zoo - GNU R package for totally ordered indexed observations
r-cran-rjsonio - Serialize R objects to JSON, JavaScript Object Notation
r-cran-surveillance - GNU R package for the Modeling and Monitoring of Epidemic Phenomena
